#####################################
#.....#####.....#####.....#####.....#
###.#########.#########.#########.###
###...........#########...........###
###.####.####.#########.####.####.###
#.....##.##.....#####.....##.##.....#
########.###################.########
########.###################.########
########.....................########
########.#########.#########.########
########.#########.#########.########
#.....##.##.....##.##.....##.##.....#
###.####.####.####.####.####.####.###
###...........####.####...........###
###.#########.####.####.#########.###
#.....#####.....##.##.....#####.....#
##################.##################
##################.##################
#S.................##################
##################.##################
##################.##################
#.....#####.....##.##.....#####.....#
###.#########.####.####.#########.###
###...........####.####...........###
###.####.####.####.####.####.####.###
#.....##.##.....##.##.....##.##.....#
########.#########.#########.########
########.#########.#########.########
########.....................########
########.###################.########
########.###################.########
#.....##.##.....#####.....##.##.....#
###.####.####.#########.####.####.###
###...........#########...........###
###.#########.#########.#########.###
#.....#####.....#####.....#####....G#
#####################################