#################
#...#...#...#...#
#.r.#.r.#.r.#...#
#...#...#...#...#
#S..D..GD..GD..G#
#...#...#...#...#
#.b.#.b.#.b.#...#
#...#...#...#...#
#################